Name,Volume,Ask Size,Ask Price,Bid Size,Bid Price,Last Price,Shares Matched,Shares Routed
UVXY,1364843,0,0.00,0,0.00,14.21,1356115,8728
VXX,1033200,0,0.00,0,0.00,21.23,1015636,17564
UVIX,1030311,0,0.00,0,0.00,2.99,1024879,5432
IEFA,606986,0,0.00,0,0.00,66.90,603915,3071
USHY,460787,0,0.00,0,0.00,35.29,452791,7996
VIXY,427363,0,0.00,0,0.00,21.24,423168,4195
ITB,313057,0,0.00,0,0.00,87.49,311241,1816
ARKG,259530,0,0.00,0,0.00,32.41,259077,453
INDA,234749,0,0.00,0,0.00,44.28,196819,37930
GOVT,221731,0,0.00,0,0.00,22.44,220986,745
USMV,160688,0,0.00,0,0.00,75.03,160588,100
CBOE,154375,0,0.00,0,0.00,150.36,153394,981
IGV,152383,0,0.00,0,0.00,361.71,151931,452
EZU,133562,0,0.00,0,0.00,44.54,130490,3072
FLOT,131010,0,0.00,0,0.00,50.64,130336,674
SVIX,114865,0,0.00,0,0.00,31.43,114769,96
EFV,110596,0,0.00,0,0.00,49.51,110564,32
ECH,109591,0,0.00,0,0.00,28.46,109243,348
SVXY,101551,0,0.00,0,0.00,90.89,101458,93
COWZ,95333,0,0.00,0,0.00,51.60,95333,0
GVI,94304,0,0.00,0,0.00,102.29,94304,0
BITX,92399,0,0.00,0,0.00,9.76,91739,660
PSEP,91887,0,0.00,0,0.00,33.34,89590,2297
NOBL,78897,0,0.00,0,0.00,94.57,78896,1
BUFR,72736,0,0.00,0,0.00,25.35,67247,5489
BBJP,69242,0,0.00,0,0.00,51.76,62312,6930
MOAT,64142,0,0.00,0,0.00,80.73,63851,291
VUSB,62980,0,0.00,0,0.00,49.06,61537,1443
AAAU,61905,0,0.00,0,0.00,19.23,61805,100
QUAL,60924,0,0.00,0,0.00,139.84,60804,120
ICSH,60363,0,0.00,0,0.00,50.18,59252,1111
PAVE,59298,0,0.00,0,0.00,32.61,51318,7980
HEFA,59230,0,0.00,0,0.00,30.52,59230,0
TLTW,48765,0,0.00,0,0.00,30.87,48486,279
IAGG,45540,0,0.00,0,0.00,49.30,44176,1364
IYT,44258,0,0.00,0,0.00,250.43,43140,1118
ITA,43139,0,0.00,0,0.00,116.44,43072,67
VNM,42898,0,0.00,0,0.00,15.13,42798,100
HYD,42492,0,0.00,0,0.00,50.47,41808,684
JMST,42315,0,0.00,0,0.00,50.47,38052,4263
CALF,42072,0,0.00,0,0.00,43.58,41872,200
RDVI,40523,0,0.00,0,0.00,22.17,40123,400
REM,40112,0,0.00,0,0.00,24.30,40112,0
BBEU,38893,0,0.00,0,0.00,53.24,36428,2465
DFIC,36138,0,0.00,0,0.00,24.39,34629,1509
EEMV,32517,0,0.00,0,0.00,54.55,31829,688
OMFL,32305,0,0.00,0,0.00,49.47,32112,193
MTUM,29193,0,0.00,0,0.00,147.26,28946,247
IDV,26369,0,0.00,0,0.00,26.44,26350,19
MLN,25756,0,0.00,0,0.00,17.34,25356,400
NEAR,25328,0,0.00,0,0.00,49.72,25328,0
PDEC,24830,0,0.00,0,0.00,33.75,24830,0
ACWV,24464,0,0.00,0,0.00,97.65,24206,258
KNG,21706,0,0.00,0,0.00,52.49,21382,324
ARKQ,21664,0,0.00,0,0.00,55.21,21664,0
GJUL,21573,0,0.00,0,0.00,30.76,21573,0
BSEP,21398,0,0.00,0,0.00,34.90,21398,0
EFAV,21088,0,0.00,0,0.00,67.17,20611,477
IYZ,20963,0,0.00,0,0.00,22.74,20963,0
FBCV,19766,0,0.00,0,0.00,28.23,19766,0
WTAI,19348,0,0.00,0,0.00,18.72,19348,0
CNYA,19020,0,0.00,0,0.00,28.96,18610,410
VIXM,18793,0,0.00,0,0.00,19.05,18793,0
EFG,18637,0,0.00,0,0.00,91.87,18423,214
PTLC,18616,0,0.00,0,0.00,41.99,18418,198
PICK,18221,0,0.00,0,0.00,40.86,18115,106
ESGV,16608,0,0.00,0,0.00,79.65,15626,982
GCOW,16411,0,0.00,0,0.00,33.90,16411,0
VLUE,16248,0,0.00,0,0.00,95.16,16031,217
BBCA,16213,0,0.00,0,0.00,61.13,16213,0
BBAX,15709,0,0.00,0,0.00,47.19,14709,1000
NULV,14341,0,0.00,0,0.00,35.26,14341,0
XBJL,14149,0,0.00,0,0.00,29.20,13749,400
ICVT,14013,0,0.00,0,0.00,75.99,11313,2700
DDLS,13484,0,0.00,0,0.00,31.67,13484,0
SPYI,12598,0,0.00,0,0.00,49.50,12598,0
FAUG,12365,0,0.00,0,0.00,38.67,12261,104
NULG,12247,0,0.00,0,0.00,63.99,12247,0
TJUL,12049,0,0.00,0,0.00,24.87,12049,0
IFRA,11842,0,0.00,0,0.00,39.29,11842,0
ITM,11837,0,0.00,0,0.00,45.23,11782,55
NUMG,11579,0,0.00,0,0.00,39.49,11579,0
NUSC,11085,0,0.00,0,0.00,37.46,11085,0
ICF,11055,0,0.00,0,0.00,54.44,11037,18
HYMU,10865,0,0.00,0,0.00,21.05,10865,0
IEO,10737,0,0.00,0,0.00,100.39,10737,0
XBJA,10722,0,0.00,0,0.00,24.97,10322,400
IQDG,10693,0,0.00,0,0.00,33.75,10193,500
FLBL,10325,0,0.00,0,0.00,24.09,10144,181
FBCG,10152,0,0.00,0,0.00,30.87,9152,1000
BUFD,10120,0,0.00,0,0.00,21.76,10120,0
BBUS,9928,0,0.00,0,0.00,81.34,9528,400
NUDM,9710,0,0.00,0,0.00,28.34,9710,0
VXZ,9496,0,0.00,0,0.00,16.34,9297,199
NUEM,9442,0,0.00,0,0.00,27.12,9442,0
IGE,9421,0,0.00,0,0.00,42.61,9421,0
TMFS,9354,0,0.00,0,0.00,29.39,8763,591
DFIS,9286,0,0.00,0,0.00,23.11,9270,16
LEAD,9267,0,0.00,0,0.00,58.26,9267,0
SMDV,8803,0,0.00,0,0.00,61.05,8803,0
SMIN,8799,0,0.00,0,0.00,63.88,7792,1007
FRDM,8773,0,0.00,0,0.00,30.50,8773,0
NETZ,8385,0,0.00,0,0.00,53.58,8385,0
TDV,8315,0,0.00,0,0.00,66.88,8315,0
ICOW,8303,0,0.00,0,0.00,30.74,8003,300
PAUG,8296,0,0.00,0,0.00,31.93,7930,366
BUYW,8153,0,0.00,0,0.00,13.51,8153,0
GOVZ,8028,0,0.00,0,0.00,11.66,8028,0
NUMV,7905,0,0.00,0,0.00,30.24,7905,0
REGL,7792,0,0.00,0,0.00,70.29,7189,603
BOXX,7723,0,0.00,0,0.00,103.24,6101,1622
FNOV,7602,0,0.00,0,0.00,40.82,7602,0
SYLD,7365,0,0.00,0,0.00,64.11,7365,0
PAPR,7331,0,0.00,0,0.00,31.28,7231,100
FFEB,7306,0,0.00,0,0.00,40.38,5206,2100
VFVA,7187,0,0.00,0,0.00,104.82,7187,0
JMUB,7167,0,0.00,0,0.00,49.33,6882,285
SECT,7123,0,0.00,0,0.00,44.23,7123,0
USEP,6744,0,0.00,0,0.00,30.07,6744,0
XBAP,6742,0,0.00,0,0.00,29.36,6742,0
OILK,6589,0,0.00,0,0.00,48.28,6589,0
GSUS,6564,0,0.00,0,0.00,61.75,5764,800
IBHD,6556,0,0.00,0,0.00,23.10,6556,0
LVHI,6501,0,0.00,0,0.00,27.49,6501,0
JUCY,6416,0,0.00,0,0.00,24.34,6416,0
POCT,6137,0,0.00,0,0.00,34.00,6137,0
FMIL,5999,0,0.00,0,0.00,34.34,4799,1200
RPHS,5977,0,0.00,0,0.00,8.95,5977,0
DIHP,5879,0,0.00,0,0.00,24.31,4392,1487
QJUN,5832,0,0.00,0,0.00,22.54,5832,0
FJUN,5760,0,0.00,0,0.00,42.00,5047,713
TMFC,5695,0,0.00,0,0.00,41.55,3747,1948
VSGX,5629,0,0.00,0,0.00,52.79,5629,0
JCPB,5365,0,0.00,0,0.00,45.63,5332,33
EMGF,5233,0,0.00,0,0.00,42.23,5233,0
CEMB,5154,0,0.00,0,0.00,42.74,4821,333
ESML,5047,0,0.00,0,0.00,36.30,4947,100
DWAT,4853,0,0.00,0,0.00,10.19,4853,0
GAUG,4852,0,0.00,0,0.00,30.31,4852,0
TFJL,4802,0,0.00,0,0.00,19.44,4802,0
FGRO,4797,0,0.00,0,0.00,17.36,4697,100
OMFS,4745,0,0.00,0,0.00,36.87,4745,0
FLQM,4696,0,0.00,0,0.00,45.47,4696,0
SMMV,4661,0,0.00,0,0.00,34.54,3998,663
PSFF,4651,0,0.00,0,0.00,24.68,4651,0
XJUL,4534,0,0.00,0,0.00,30.86,4534,0
RSBT,4343,0,0.00,0,0.00,17.65,4343,0
FMAY,4311,0,0.00,0,0.00,39.45,4311,0
MFUL,4300,0,0.00,0,0.00,21.55,4300,0
YPS,4086,0,0.00,0,0.00,22.19,4086,0
SMOT,3998,0,0.00,0,0.00,30.16,3998,0
IGLD,3966,0,0.00,0,0.00,18.85,3966,0
FOCT,3879,0,0.00,0,0.00,38.33,3879,0
FJUL,3792,0,0.00,0,0.00,39.66,3782,10
PTMC,3701,0,0.00,0,0.00,33.54,3640,61
MOHR,3695,0,0.00,0,0.00,19.48,3695,0
DISV,3607,0,0.00,0,0.00,24.60,3607,0
PJUN,3489,0,0.00,0,0.00,32.01,2140,1349
FAPR,3485,0,0.00,0,0.00,33.27,3439,46
BBIN,3454,0,0.00,0,0.00,54.22,3454,0
FLQL,3407,0,0.00,0,0.00,45.49,2063,1344
UNOV,3400,0,0.00,0,0.00,31.25,2100,1300
JULJ,3377,0,0.00,0,0.00,25.14,3286,91
JULH,3370,0,0.00,0,0.00,25.15,2965,405
FSEP,3214,0,0.00,0,0.00,38.53,3214,0
UOCT,3208,0,0.00,0,0.00,30.32,3208,0
FJAN,3175,0,0.00,0,0.00,37.70,3175,0
BALT,3165,0,0.00,0,0.00,28.16,3165,0
SHYD,3146,0,0.00,0,0.00,22.02,3146,0
FMAR,3117,0,0.00,0,0.00,36.07,3117,0
XMPT,3101,0,0.00,0,0.00,20.35,3101,0
FLIA,2959,0,0.00,0,0.00,19.66,2959,0
JPLD,2952,0,0.00,0,0.00,49.87,2904,48
FDEC,2940,0,0.00,0,0.00,36.59,2940,0
PRNT,2938,0,0.00,0,0.00,22.17,2938,0
EMDV,2909,0,0.00,0,0.00,45.18,2909,0
UAPR,2807,0,0.00,0,0.00,26.37,2807,0
IBHE,2786,0,0.00,0,0.00,22.97,2786,0
IGHG,2704,0,0.00,0,0.00,73.41,2704,0
ATMP,2703,0,0.00,0,0.00,21.09,2703,0
OUSM,2688,0,0.00,0,0.00,36.83,2688,0
MOTI,2686,0,0.00,0,0.00,31.31,1663,1023
SMMD,2673,0,0.00,0,0.00,58.56,2673,0
TMAT,2646,0,0.00,0,0.00,14.66,2246,400
IBHF,2623,0,0.00,0,0.00,22.64,2623,0
DRSK,2597,0,0.00,0,0.00,24.67,2597,0
YJUN,2567,0,0.00,0,0.00,20.29,2167,400
DFNL,2559,0,0.00,0,0.00,27.83,2559,0
GJUN,2502,0,0.00,0,0.00,30.49,2502,0
XDEC,2442,0,0.00,0,0.00,33.11,2201,241
SLVP,2409,0,0.00,0,0.00,9.54,2409,0
JEMA,2400,0,0.00,0,0.00,36.13,2400,0
QVAL,2392,0,0.00,0,0.00,37.77,2197,195
XDOC,2310,0,0.00,0,0.00,24.93,2310,0
XJUN,2308,0,0.00,0,0.00,33.84,2308,0
KAPR,2302,0,0.00,0,0.00,27.91,402,1900
DUSA,2290,0,0.00,0,0.00,33.02,2290,0
ARKX,2265,0,0.00,0,0.00,14.62,2045,220
OGIG,2264,0,0.00,0,0.00,32.06,2264,0
JBBB,2237,0,0.00,0,0.00,47.41,2237,0
SATO,2216,0,0.00,0,0.00,8.60,2216,0
PFEB,2205,0,0.00,0,0.00,31.22,2205,0
FLHY,2175,0,0.00,0,0.00,22.77,2175,0
HYBL,2139,0,0.00,0,0.00,27.64,2139,0
MSTB,2128,0,0.00,0,0.00,27.36,2128,0
GJAN,2108,0,0.00,0,0.00,32.99,2108,0
FLTN,2100,0,0.00,0,0.00,20.35,2100,0
RESD,2100,0,0.00,0,0.00,27.72,2100,0
TUSI,2100,0,0.00,0,0.00,25.03,1800,300
LQDW,2071,0,0.00,0,0.00,32.36,1871,200
EDEN,2038,0,0.00,0,0.00,104.58,2038,0
DMAR,2000,0,0.00,0,0.00,32.64,1100,900
GMAY,1995,0,0.00,0,0.00,31.55,1995,0
FYLD,1994,0,0.00,0,0.00,24.41,1994,0
DJUL,1940,0,0.00,0,0.00,34.99,1940,0
IBHG,1925,0,0.00,0,0.00,21.73,1925,0
BRLN,1900,0,0.00,0,0.00,52.33,1800,100
KJAN,1847,0,0.00,0,0.00,32.39,1847,0
XBTF,1789,0,0.00,0,0.00,24.89,1788,1
EMHY,1770,0,0.00,0,0.00,34.68,1692,78
EYLD,1761,0,0.00,0,0.00,29.01,1761,0
TBJL,1753,0,0.00,0,0.00,19.47,1753,0
XSEP,1752,0,0.00,0,0.00,34.39,1752,0
GTIP,1713,0,0.00,0,0.00,47.99,1713,0
IBHI,1701,0,0.00,0,0.00,22.17,1701,0
IBML,1699,0,0.00,0,0.00,25.47,1699,0
GMOM,1680,0,0.00,0,0.00,27.75,1680,0
LQDI,1679,0,0.00,0,0.00,25.21,1679,0
HYDB,1675,0,0.00,0,0.00,44.59,1675,0
TOKE,1675,0,0.00,0,0.00,6.19,1675,0
GDE,1672,0,0.00,0,0.00,25.57,1672,0
TMFG,1657,0,0.00,0,0.00,27.41,1657,0
VFMO,1635,0,0.00,0,0.00,121.84,1635,0
FCTR,1617,0,0.00,0,0.00,26.14,1617,0
GAA,1616,0,0.00,0,0.00,26.83,1616,0
PBUS,1616,0,0.00,0,0.00,45.05,1616,0
SMAY,1602,0,0.00,0,0.00,21.10,1602,0
OUSA,1585,0,0.00,0,0.00,44.28,1535,50
MEAR,1576,0,0.00,0,0.00,49.82,1576,0
CEFS,1567,0,0.00,0,0.00,18.50,1490,77
FSMO,1550,0,0.00,0,0.00,22.38,1450,100
BUFF,1546,0,0.00,0,0.00,38.44,1546,0
WUGI,1523,0,0.00,0,0.00,47.53,1523,0
HYXU,1508,0,0.00,0,0.00,47.04,1508,0
DUDE,1500,0,0.00,0,0.00,21.73,1500,0
SEPZ,1500,0,0.00,0,0.00,33.24,1500,0
PJAN,1486,0,0.00,0,0.00,35.65,1386,100
GEMD,1481,0,0.00,0,0.00,39.33,1321,160
FCLD,1477,0,0.00,0,0.00,20.21,1477,0
HAUS,1469,0,0.00,0,0.00,15.74,1469,0
EWGS,1460,0,0.00,0,0.00,59.82,1460,0
ZIVB,1456,0,0.00,0,0.00,20.38,1456,0
PAWZ,1455,0,0.00,0,0.00,50.22,1455,0
WFHY,1443,0,0.00,0,0.00,44.28,1443,0
IGEB,1424,0,0.00,0,0.00,43.31,1424,0
NURE,1406,0,0.00,0,0.00,29.05,1406,0
XMAR,1389,0,0.00,0,0.00,31.86,1389,0
GLOV,1386,0,0.00,0,0.00,41.44,1386,0
PSFJ,1380,0,0.00,0,0.00,24.00,1380,0
RESE,1362,0,0.00,0,0.00,28.27,1362,0
FDRV,1305,0,0.00,0,0.00,18.68,1305,0
XDSQ,1304,0,0.00,0,0.00,29.39,1079,225
FLDR,1286,0,0.00,0,0.00,49.68,1286,0
JPIB,1283,0,0.00,0,0.00,46.06,1283,0
EPRF,1281,0,0.00,0,0.00,17.89,1281,0
IYJ,1278,0,0.00,0,0.00,108.36,1278,0
QDEC,1257,0,0.00,0,0.00,22.73,1257,0
HYGW,1236,0,0.00,0,0.00,35.22,1236,0
SNPD,1206,0,0.00,0,0.00,25.07,706,500
GMAR,1202,0,0.00,0,0.00,32.19,1202,0
BBIB,1201,0,0.00,0,0.00,96.57,1201,0
SNAV,1184,0,0.00,0,0.00,27.23,1184,0
FFTI,1174,0,0.00,0,0.00,20.23,1174,0
GSEW,1173,0,0.00,0,0.00,63.15,1173,0
WEED,1173,0,0.00,0,0.00,28.10,1173,0
YMAR,1150,0,0.00,0,0.00,20.96,1150,0
HSRT,1130,0,0.00,0,0.00,38.23,1130,0
PWS,1129,0,0.00,0,0.00,27.90,1129,0
HEGD,1119,0,0.00,0,0.00,18.79,1119,0
APRH,1102,0,0.00,0,0.00,25.09,1102,0
QTJL,1102,0,0.00,0,0.00,25.67,402,700
IDUB,1101,0,0.00,0,0.00,19.85,1101,0
BJUN,1085,0,0.00,0,0.00,34.01,1085,0
IETC,1081,0,0.00,0,0.00,57.02,1081,0
SVAL,1061,0,0.00,0,0.00,28.33,1061,0
VEGN,1047,0,0.00,0,0.00,41.90,847,200
BAPR,1046,0,0.00,0,0.00,36.25,1046,0
HYIN,1043,0,0.00,0,0.00,18.92,932,111
FPRO,1029,0,0.00,0,0.00,20.15,1029,0
RULE,1027,0,0.00,0,0.00,19.75,1027,0
IMFL,1017,0,0.00,0,0.00,24.18,1017,0
JULD,1007,0,0.00,0,0.00,25.16,1007,0
IBHJ,1000,0,0.00,0,0.00,25.22,1000,0
TTAI,1000,0,0.00,0,0.00,27.29,1000,0
IZRL,990,0,0.00,0,0.00,19.59,990,0
ISDB,968,0,0.00,0,0.00,24.76,968,0
BBHY,918,0,0.00,0,0.00,44.62,918,0
IYLD,918,0,0.00,0,0.00,19.37,918,0
ACIO,917,0,0.00,0,0.00,31.61,917,0
VAMO,913,0,0.00,0,0.00,27.24,313,600
BJUL,901,0,0.00,0,0.00,35.73,901,0
IBMQ,900,0,0.00,0,0.00,24.85,900,0
HCRB,897,0,0.00,0,0.00,34.02,897,0
XDQQ,897,0,0.00,0,0.00,25.87,897,0
NJUL,895,0,0.00,0,0.00,52.05,895,0
FCPI,881,0,0.00,0,0.00,33.72,881,0
WFIG,865,0,0.00,0,0.00,43.15,865,0
XBOC,861,0,0.00,0,0.00,26.09,861,0
DAUG,855,0,0.00,0,0.00,33.99,855,0
GDMN,852,0,0.00,0,0.00,23.37,852,0
XDJL,850,0,0.00,0,0.00,28.37,850,0
TGLR,844,0,0.00,0,0.00,24.25,844,0
ENOR,841,0,0.00,0,0.00,23.10,841,0
PMAR,836,0,0.00,0,0.00,34.19,836,0
DFRA,830,0,0.00,0,0.00,28.39,830,0
IMOM,810,0,0.00,0,0.00,25.49,810,0
BBLB,805,0,0.00,0,0.00,90.85,805,0
FLQS,756,0,0.00,0,0.00,36.36,756,0
SAUG,755,0,0.00,0,0.00,20.39,755,0
IVAL,747,0,0.00,0,0.00,24.51,747,0
BUFB,741,0,0.00,0,0.00,26.50,741,0
ADME,720,0,0.00,0,0.00,36.91,720,0
TILT,710,0,0.00,0,0.00,172.57,710,0
UJUL,708,0,0.00,0,0.00,29.10,708,0
PTEU,707,0,0.00,0,0.00,26.20,707,0
FPFD,703,0,0.00,0,0.00,20.12,703,0
FFTG,702,0,0.00,0,0.00,24.52,702,0
MDLV,701,0,0.00,0,0.00,23.99,701,0
OSCV,671,0,0.00,0,0.00,32.44,671,0
BAUG,654,0,0.00,0,0.00,34.28,654,0
TYA,649,0,0.00,0,0.00,13.77,649,0
VCEB,639,0,0.00,0,0.00,60.71,639,0
IBHC,636,0,0.00,0,0.00,23.58,636,0
IQM,635,0,0.00,0,0.00,47.63,635,0
DDWM,620,0,0.00,0,0.00,31.20,620,0
CSM,618,0,0.00,0,0.00,51.49,618,0
HEEM,612,0,0.00,0,0.00,24.51,512,100
BUFG,607,0,0.00,0,0.00,20.40,607,0
FFHG,603,0,0.00,0,0.00,33.17,603,0
INTL,602,0,0.00,0,0.00,20.82,602,0
IGRO,589,0,0.00,0,0.00,61.74,589,0
AESR,582,0,0.00,0,0.00,12.90,582,0
GVAL,567,0,0.00,0,0.00,20.27,567,0
DFEB,543,0,0.00,0,0.00,35.81,543,0
JCPI,543,0,0.00,0,0.00,45.79,543,0
DURA,541,0,0.00,0,0.00,31.52,541,0
EFAD,540,0,0.00,0,0.00,36.90,540,0
TMFM,536,0,0.00,0,0.00,24.73,536,0
KRUZ,535,0,0.00,0,0.00,26.00,535,0
FMAG,534,0,0.00,0,0.00,22.51,534,0
VOTE,528,0,0.00,0,0.00,52.54,528,0
FRNW,527,0,0.00,0,0.00,17.77,427,100
NULC,527,0,0.00,0,0.00,37.26,527,0
VFMF,520,0,0.00,0,0.00,108.16,520,0
ROMO,501,0,0.00,0,0.00,26.01,501,0
PBTP,500,0,0.00,0,0.00,24.62,500,0
QVOY,500,0,0.00,0,0.00,28.11,500,0
BUFQ,488,0,0.00,0,0.00,25.56,488,0
XAUG,486,0,0.00,0,0.00,30.18,486,0
ESG,450,0,0.00,0,0.00,110.34,450,0
PJUL,450,0,0.00,0,0.00,34.67,375,75
IBMN,449,0,0.00,0,0.00,26.25,449,0
HYHG,447,0,0.00,0,0.00,61.64,447,0
XJH,437,0,0.00,0,0.00,36.32,437,0
USMF,423,0,0.00,0,0.00,39.54,423,0
KWT,414,0,0.00,0,0.00,31.66,414,0
BFEB,411,0,0.00,0,0.00,34.67,411,0
DIVB,410,0,0.00,0,0.00,39.23,389,21
TAIL,406,0,0.00,0,0.00,13.12,406,0
QTJA,402,0,0.00,0,0.00,20.66,402,0
MPRO,399,0,0.00,0,0.00,25.49,399,0
PSDM,399,0,0.00,0,0.00,50.21,399,0
NJAN,395,0,0.00,0,0.00,40.56,395,0
XSHQ,395,0,0.00,0,0.00,37.60,395,0
NANC,392,0,0.00,0,0.00,28.46,392,0
QMOM,378,0,0.00,0,0.00,46.03,378,0
FDG,370,0,0.00,0,0.00,67.41,370,0
SPMV,354,0,0.00,0,0.00,38.07,354,0
IBMP,339,0,0.00,0,0.00,24.81,339,0
XDAP,336,0,0.00,0,0.00,29.10,336,0
BBRE,321,0,0.00,0,0.00,84.15,320,1
TRTY,313,0,0.00,0,0.00,24.63,313,0
ADFI,310,0,0.00,0,0.00,8.40,310,0
DAPR,304,0,0.00,0,0.00,31.07,304,0
GSEE,300,0,0.00,0,0.00,41.20,300,0
IVVM,300,0,0.00,0,0.00,25.67,300,0
MSVX,300,0,0.00,0,0.00,23.36,300,0
BCHP,286,0,0.00,0,0.00,25.95,286,0
LCF,284,0,0.00,0,0.00,29.09,284,0
STLG,284,0,0.00,0,0.00,37.31,284,0
DFHY,283,0,0.00,0,0.00,20.77,283,0
FFSG,275,0,0.00,0,0.00,32.86,275,0
MAMB,268,0,0.00,0,0.00,21.60,268,0
SMB,266,0,0.00,0,0.00,16.80,266,0
EFNL,264,0,0.00,0,0.00,34.36,264,0
BJAN,263,0,0.00,0,0.00,38.31,263,0
DFNV,263,0,0.00,0,0.00,26.03,263,0
KJUL,261,0,0.00,0,0.00,26.09,161,100
EMTL,251,0,0.00,0,0.00,40.69,251,0
GHYG,241,0,0.00,0,0.00,42.29,236,5
IBMM,238,0,0.00,0,0.00,25.71,238,0
ICLO,225,0,0.00,0,0.00,25.62,225,0
DUBS,217,0,0.00,0,0.00,25.86,217,0
STOT,215,0,0.00,0,0.00,46.43,215,0
GSST,214,0,0.00,0,0.00,49.78,214,0
LJIM,212,0,0.00,0,0.00,26.56,212,0
GFEB,205,0,0.00,0,0.00,31.55,205,0
DJAN,200,0,0.00,0,0.00,33.17,200,0
DSEP,200,0,0.00,0,0.00,35.00,200,0
QTOC,200,0,0.00,0,0.00,22.96,200,0
RMIF,200,0,0.00,0,0.00,25.28,200,0
VWID,200,0,0.00,0,0.00,25.72,0,200
DFND,190,0,0.00,0,0.00,37.83,190,0
EVUS,172,0,0.00,0,0.00,24.85,172,0
DWLD,171,0,0.00,0,0.00,29.13,171,0
NOCT,171,0,0.00,0,0.00,42.25,171,0
HSUN,160,0,0.00,0,0.00,33.01,160,0
BDEC,159,0,0.00,0,0.00,36.67,159,0
XEMD,154,0,0.00,0,0.00,39.45,154,0
XJR,152,0,0.00,0,0.00,35.81,52,100
XSHD,152,0,0.00,0,0.00,16.06,152,0
FIBR,151,0,0.00,0,0.00,83.41,151,0
PMAY,151,0,0.00,0,0.00,30.16,151,0
MDEV,150,0,0.00,0,0.00,19.62,150,0
FDEM,146,0,0.00,0,0.00,22.95,146,0
BOCT,134,0,0.00,0,0.00,37.26,134,0
DINT,126,0,0.00,0,0.00,18.97,126,0
PNOV,126,0,0.00,0,0.00,34.50,126,0
RSEE,125,0,0.00,0,0.00,26.55,125,0
BMAY,123,0,0.00,0,0.00,32.17,123,0
BNOV,110,0,0.00,0,0.00,34.56,110,0
BGLD,105,0,0.00,0,0.00,19.70,105,0
UAUG,105,0,0.00,0,0.00,29.53,105,0
MOTG,103,0,0.00,0,0.00,34.03,103,0
SHAG,103,0,0.00,0,0.00,46.65,103,0
SUPP,103,0,0.00,0,0.00,52.69,103,0
FPAG,102,0,0.00,0,0.00,24.72,102,0
GLDB,102,0,0.00,0,0.00,19.06,102,0
QSPT,102,0,0.00,0,0.00,21.96,102,0
UMAY,102,0,0.00,0,0.00,28.23,102,0
XTJL,102,0,0.00,0,0.00,27.84,102,0
OEUR,101,0,0.00,0,0.00,26.98,101,0
BKGI,100,0,0.00,0,0.00,27.73,100,0
BMAR,100,0,0.00,0,0.00,37.67,100,0
BUFT,100,0,0.00,0,0.00,20.11,100,0
DJUN,100,0,0.00,0,0.00,36.44,100,0
IBMR,100,0,0.00,0,0.00,24.46,100,0
MBCC,100,0,0.00,0,0.00,27.63,100,0
ROYA,100,0,0.00,0,0.00,25.86,100,0
YSEP,100,0,0.00,0,0.00,19.81,100,0
EGUS,98,0,0.00,0,0.00,31.64,98,0
IBMO,97,0,0.00,0,0.00,25.03,97,0
APRD,96,0,0.00,0,0.00,25.28,96,0
XVV,95,0,0.00,0,0.00,34.33,95,0
TTAC,91,0,0.00,0,0.00,53.35,91,0
IAUF,75,0,0.00,0,0.00,57.92,75,0
GAPR,74,0,0.00,0,0.00,31.38,74,0
RODE,69,0,0.00,0,0.00,25.76,69,0
VFQY,67,0,0.00,0,0.00,118.08,67,0
BLKC,65,0,0.00,0,0.00,13.52,65,0
WDNA,65,0,0.00,0,0.00,16.87,65,0
FLV,64,0,0.00,0,0.00,59.35,64,0
ESGG,57,0,0.00,0,0.00,141.05,57,0
XDJA,57,0,0.00,0,0.00,23.54,57,0
LKOR,51,0,0.00,0,0.00,42.03,51,0
VFMV,51,0,0.00,0,0.00,100.28,51,0
JULQ,50,0,0.00,0,0.00,25.02,50,0
FDEV,49,0,0.00,0,0.00,25.66,49,0
DNOV,41,0,0.00,0,0.00,36.92,41,0
RDFI,34,0,0.00,0,0.00,22.11,34,0
FDHT,32,0,0.00,0,0.00,18.15,32,0
IPPP,28,0,0.00,0,0.00,9.36,28,0
HFGO,24,0,0.00,0,0.00,15.81,24,0
IBHH,23,0,0.00,0,0.00,22.55,23,0
UFEB,22,0,0.00,0,0.00,28.19,22,0
IPDP,21,0,0.00,0,0.00,16.68,21,0
UJAN,21,0,0.00,0,0.00,33.22,21,0
RVRB,20,0,0.00,0,0.00,23.54,20,0
NAPR,16,0,0.00,0,0.00,42.37,16,0
XUSP,16,0,0.00,0,0.00,28.96,16,0
AFIF,10,0,0.00,0,0.00,8.95,10,0
BBIP,10,0,0.00,0,0.00,97.50,10,0
SFIG,10,0,0.00,0,0.00,46.83,10,0
WBAT,10,0,0.00,0,0.00,32.59,10,0
PSMJ,9,0,0.00,0,0.00,23.89,9,0
SNPG,8,0,0.00,0,0.00,33.18,8,0
BBSA,7,0,0.00,0,0.00,47.03,7,0
QPFF,7,0,0.00,0,0.00,35.21,7,0
SNPV,6,0,0.00,0,0.00,26.83,6,0
TOLL,6,0,0.00,0,0.00,26.28,6,0
IVRA,5,0,0.00,0,0.00,13.57,5,0
MRGR,5,0,0.00,0,0.00,39.67,5,0
SHDG,5,0,0.00,0,0.00,24.79,5,0
DALT,4,0,0.00,0,0.00,8.75,4,0
HELX,4,0,0.00,0,0.00,30.92,4,0
QLC,4,0,0.00,0,0.00,50.09,4,0
RTAI,4,0,0.00,0,0.00,19.61,4,0
BUYZ,3,0,0.00,0,0.00,26.08,2,1
EAOK,3,0,0.00,0,0.00,24.04,3,0
EUDV,3,0,0.00,0,0.00,44.49,3,0
EWUS,3,0,0.00,0,0.00,32.52,3,0
GDMA,3,0,0.00,0,0.00,29.74,3,0
APRQ,2,0,0.00,0,0.00,24.75,2,0
BLDG,2,0,0.00,0,0.00,24.48,2,0
CLSE,2,0,0.00,0,0.00,16.36,2,0
CVAR,2,0,0.00,0,0.00,24.09,2,0
DSCF,2,0,0.00,0,0.00,21.57,2,0
EAOR,2,0,0.00,0,0.00,27.97,2,0
ESHY,2,0,0.00,0,0.00,18.12,2,0
IEDI,2,0,0.00,0,0.00,40.92,2,0
IVVB,2,0,0.00,0,0.00,25.65,2,0
MAGA,2,0,0.00,0,0.00,40.28,2,0
PEX,2,0,0.00,0,0.00,27.94,2,0
SJIM,2,0,0.00,0,0.00,23.65,2,0
UJUN,2,0,0.00,0,0.00,28.92,2,0
VMOT,2,0,0.00,0,0.00,23.02,2,0
XTOC,2,0,0.00,0,0.00,24.51,2,0
XVOL,2,0,0.00,0,0.00,18.66,2,0
ACSI,1,0,0.00,0,0.00,46.67,1,0
APRJ,1,0,0.00,0,0.00,24.89,1,0
BBSB,1,0,0.00,0,0.00,98.23,1,0
CMCI,1,0,0.00,0,0.00,25.76,1,0
DBOC,1,0,0.00,0,0.00,31.63,1,0
DOGG,1,0,0.00,0,0.00,20.58,1,0
MINN,1,0,0.00,0,0.00,21.70,1,0
PXUS,1,0,0.00,0,0.00,22.22,1,0
QMAR,1,0,0.00,0,0.00,24.39,1,0
SDVD,1,0,0.00,0,0.00,19.87,1,0
VIRS,1,0,0.00,0,0.00,31.70,0,1
APRZ,0,0,0.00,0,0.00,0.00,0,0
ARCM,0,0,0.00,0,0.00,0.00,0,0
AUGZ,0,0,0.00,0,0.00,0.00,0,0
BBEM,0,0,0.00,0,0.00,0.00,0,0
BEMB,0,0,0.00,0,0.00,0.00,0,0
BOSS,0,0,0.00,0,0.00,0.00,0,0
CAOS,0,0,0.00,0,0.00,0.00,0,0
CFCV,0,0,0.00,0,0.00,0.00,0,0
DBJA,0,0,0.00,0,0.00,0.00,0,0
DDEC,0,0,0.00,0,0.00,0.00,0,0
DECZ,0,0,0.00,0,0.00,0.00,0,0
DKRB,0,0,0.00,0,0.00,0.00,0,0
DMAY,0,0,0.00,0,0.00,0.00,0,0
DOCT,0,0,0.00,0,0.00,0.00,0,0
DSJA,0,0,0.00,0,0.00,0.00,0,0
DSOC,0,0,0.00,0,0.00,0.00,0,0
DWCR,0,0,0.00,0,0.00,0.00,0,0
EAOA,0,0,0.00,0,0.00,0.00,0,0
EAOM,0,0,0.00,0,0.00,0.00,0,0
ESCR,0,0,0.00,0,0.00,0.00,0,0
ESEB,0,0,0.00,0,0.00,0.00,0,0
FAIL,0,0,0.00,0,0.00,0.00,0,0
FEBZ,0,0,0.00,0,0.00,0.00,0,0
FLDZ,0,0,0.00,0,0.00,0.00,0,0
FUNL,0,0,0.00,0,0.00,0.00,0,0
GCLN,0,0,0.00,0,0.00,0.00,0,0
GHTA,0,0,0.00,0,0.00,0.00,0,0
GPAL,0,0,0.00,0,0.00,0.00,0,0
GPOW,0,0,0.00,0,0.00,0.00,0,0
GSID,0,0,0.00,0,0.00,0.00,0,0
HEAT,0,0,0.00,0,0.00,0.00,0,0
HIDE,0,0,0.00,0,0.00,0.00,0,0
HIYS,0,0,0.00,0,0.00,0.00,0,0
IMSI,0,0,0.00,0,0.00,0.00,0,0
ISVL,0,0,0.00,0,0.00,0.00,0,0
JANZ,0,0,0.00,0,0.00,0.00,0,0
JULZ,0,0,0.00,0,0.00,0.00,0,0
JUNZ,0,0,0.00,0,0.00,0.00,0,0
KCAL,0,0,0.00,0,0.00,0.00,0,0
KOCT,0,0,0.00,0,0.00,0.00,0,0
MARZ,0,0,0.00,0,0.00,0.00,0,0
MAYZ,0,0,0.00,0,0.00,0.00,0,0
MBBB,0,0,0.00,0,0.00,0.00,0,0
MBND,0,0,0.00,0,0.00,0.00,0,0
MBNE,0,0,0.00,0,0.00,0.00,0,0
MIG,0,0,0.00,0,0.00,0.00,0,0
MOTE,0,0,0.00,0,0.00,0.00,0,0
MSMR,0,0,0.00,0,0.00,0.00,0,0
MSTQ,0,0,0.00,0,0.00,0.00,0,0
NOVZ,0,0,0.00,0,0.00,0.00,0,0
NUDV,0,0,0.00,0,0.00,0.00,0,0
OBND,0,0,0.00,0,0.00,0.00,0,0
OCTZ,0,0,0.00,0,0.00,0.00,0,0
PBL,0,0,0.00,0,0.00,0.00,0,0
PIT,0,0,0.00,0,0.00,0.00,0,0
PLRG,0,0,0.00,0,0.00,0.00,0,0
PLTL,0,0,0.00,0,0.00,0.00,0,0
PSCJ,0,0,0.00,0,0.00,0.00,0,0
PSCQ,0,0,0.00,0,0.00,0.00,0,0
PSCW,0,0,0.00,0,0.00,0.00,0,0
PSCX,0,0,0.00,0,0.00,0.00,0,0
PSFD,0,0,0.00,0,0.00,0.00,0,0
PSFM,0,0,0.00,0,0.00,0.00,0,0
PSFO,0,0,0.00,0,0.00,0.00,0,0
PSMD,0,0,0.00,0,0.00,0.00,0,0
PSMO,0,0,0.00,0,0.00,0.00,0,0
PSMR,0,0,0.00,0,0.00,0.00,0,0
PUTD,0,0,0.00,0,0.00,0.00,0,0
QCON,0,0,0.00,0,0.00,0.00,0,0
QTAP,0,0,0.00,0,0.00,0.00,0,0
ROCI,0,0,0.00,0,0.00,0.00,0,0
RYSE,0,0,0.00,0,0.00,0.00,0,0
SANE,0,0,0.00,0,0.00,0.00,0,0
SEIM,0,0,0.00,0,0.00,0.00,0,0
SEIQ,0,0,0.00,0,0.00,0.00,0,0
SEIV,0,0,0.00,0,0.00,0.00,0,0
SELV,0,0,0.00,0,0.00,0.00,0,0
SMI,0,0,0.00,0,0.00,0.00,0,0
SPCZ,0,0,0.00,0,0.00,0.00,0,0
STLV,0,0,0.00,0,0.00,0.00,0,0
TDVI,0,0,0.00,0,0.00,0.00,0,0
TMDV,0,0,0.00,0,0.00,0.00,0,0
TSJA,0,0,0.00,0,0.00,0.00,0,0
TSLH,0,0,0.00,0,0.00,0.00,0,0
TSOC,0,0,0.00,0,0.00,0.00,0,0
UDEC,0,0,0.00,0,0.00,0.00,0,0
UMAR,0,0,0.00,0,0.00,0.00,0,0
VMAT,0,0,0.00,0,0.00,0.00,0,0
WLDR,0,0,0.00,0,0.00,0.00,0,0
XDAT,0,0,0.00,0,0.00,0.00,0,0
XTAP,0,0,0.00,0,0.00,0.00,0,0
XTJA,0,0,0.00,0,0.00,0.00,0,0
YDEC,0,0,0.00,0,0.00,0.00,0,0
ZECP,0,0,0.00,0,0.00,0.00,0,0